R 1920 800
NO ./textures/wood.xpm
SO ./textures/stone.xpm
WE ./textures/metal.xpm
EA ./textures/brick.xpm
S ./textures/sprite.xpm

F 220,100,20
C 225,30,0

11111111111111111111
10000011000010000001
10000000020000020001
10000000000000000001
10000000000000000001
110000000N0000000211
10000000000000000011
11000000000000200001
10000000000000100001
11111111111111111111