R 1600 800
NO ./textures/wood.xpm
SO ./textures/stone.xpm
WE ./textures/metal.xpm
EA ./textures/brick.xpm
S ./textures/sprite.xpm
F 184,113,39
C 51,198

1111111111111
1020000000021
100N000000001
1000002000001
1111111111111