R 800 600
NO textures/wood.xpm
SO ./textures/stone.xpm
WE ./textures/metal.xpm
EA ./textures/brick.xpm
S ./textures/sprite.xpm

F 184,113,39
C 51,198,227

1111111111111111
1000000000000001
1000002000000001
1000000000000001
1000000N00000001
1000000000000001
1000000000000001
1000000000000001
1111111111111111